#....................................#
#.1.......c.................c........#
#........###...............###.......#
#.#....................#.............#
#.....c..#....#.........#.......c....#
#....###..#..###.......###.....###...#
#...........#.....#..#....#..........#
#........##......###........##...X...#
######################################