#                                                     #
# 1       c                 c                         #
#        ###               ###                        #
# #                    #                              #
#     c  #    #                                       #
#    ###  #  ###                                      #
#           #     #                             #######
#        ##      ###                             X    #
#####  #######  #################   ###################
     ^^       ^^                 ^^^