
            ##########
            #        #
            #        #
            #    1   #
            #   ###  #
            # cc     ########
            # cc            #
            # cc        X   #
            ###^#############
            